13
13
P--T-----T--7
E-T1--T--1T-3
E-1---+---1-3
E---T-1-T---3
E---1-T-1---3
E----7|P----3
E----+++----3
E----J|L----3
E-T---1---T-3
E-1T--T--T1-3
E--1--+--1--3
E-T---1---T-3
L-1-------1-J
